0100000000000000
0100000111111110
0100000100000010
0101111100011110
0111000000010000
0000001111110000
0000001000000000
0000001000000000
0000001000000000
0000001000000000