010000000001000000
010000011111111000
010000010000001000
010111110001111000
011100000001000000
000000111111000000
000000100000000000
000000100000000000
000000100000000000
000000100000000000